11 11 11 11 11 11 11 11 11 11 11 11 11 11 11 11 11 11 11 11 11 11 11 11 11 11 11 11 11 11 11 11 11 11 11 11 11 11 11 11 11 11 11 11 11 11 11 11 11 11
11 11 11 11 11 11 11 11 11 11 11 11 11 11 11 11 11 11 11 11 11 11 11 11 11 11 11 11 11 11 11 11 11 11 11 11 11 11 11 11 11 11 11 11 11 11 11 11 11 11
11 11 11 11 11 11 11 11 11 11 11 11 11 11 11 11 11 11 11 11 11 11 11 11 11 11 11 11 11 11 11 11 11 11 11 11 11 11 11 11 11 11 11 11 11 11 11 11 11 11
11 11 11 11 11 11 11 11 11 11 11 11 11 11 11 11 11 11 11 11 11 11 11 11 11 11 11 11 11 11 11 11 11 11 11 11 11 11 11 11 11 11 11 11 11 11 11 11 11 11
11 11 11 11 11 11 11 11 11 11 11 11 11 11 11 11 11 11 11 11 11 11 11 11 11 11 11 11 11 11 11 11 11 11 11 11 11 11 11 11 11 11 11 11 11 11 11 11 11 11
11 11 11 11 11 11 11 11 24 20 20 20 20 20 20 20 20 20 20 20 20 20 20 20 20 20 20 20 20 20 20 20 20 20 20 20 20 20 20 20 20 23 11 11 11 11 11 11 11 11
11 11 11 11 11 11 11 11 16 1 1 1 1 1 1 1 1 1 3 3 3 3 3 3 3 3 3 3 3 3 3 3 3 1 1 1 0 0 0 0 0 15 11 11 11 11 11 11 11 11
11 11 11 11 11 11 11 11 16 1 1 1 1 1 1 1 1 1 3 3 3 3 3 3 3 3 3 3 3 3 3 3 3 1 1 1 0 1 1 1 0 15 11 11 11 11 11 11 11 11
11 11 11 11 11 11 11 11 16 1 1 1 1 1 1 1 1 1 1 1 1 1 1 1 1 1 1 1 1 1 1 1 1 1 1 1 0 1 1 1 0 15 11 11 11 11 11 11 11 11
11 11 11 11 11 11 11 11 16 1 1 1 1 1 1 1 1 1 1 1 1 1 1 1 1 1 1 1 1 1 1 1 1 1 1 1 0 1 1 1 0 15 11 11 11 11 11 11 11 11
11 11 11 11 11 11 11 11 16 1 1 1 1 1 1 1 1 1 1 1 1 1 1 1 1 1 1 1 1 1 1 1 1 1 1 1 0 0 1 0 0 15 11 11 11 11 11 11 11 11
11 11 11 11 11 11 11 11 16 1 1 1 1 1 1 1 1 1 3 3 3 3 3 3 1 1 1 3 3 3 3 3 3 1 1 1 1 1 1 1 1 15 11 11 11 11 11 11 11 11
11 11 11 11 11 11 11 11 16 1 1 1 1 1 1 1 1 1 3 3 3 3 3 3 1 1 1 3 3 3 3 3 3 1 1 1 1 1 1 1 1 15 11 11 11 11 11 11 11 11
11 11 11 11 11 11 11 11 16 3 3 3 3 3 3 3 3 3 3 3 3 3 3 3 1 1 1 3 3 3 3 3 3 1 1 1 1 1 1 1 1 15 11 11 11 11 11 11 11 11
11 11 11 11 11 11 11 11 16 3 3 3 3 3 3 3 3 3 3 3 3 3 3 3 1 1 1 3 3 3 3 3 3 3 3 3 3 3 3 3 3 15 11 11 11 11 11 11 11 11
11 11 11 11 11 11 11 11 16 3 3 3 3 3 3 3 3 3 3 3 3 3 3 3 1 1 1 3 3 3 3 3 3 3 3 3 3 3 3 3 3 15 11 11 11 11 11 11 11 11
11 11 11 11 11 11 11 11 16 3 3 3 3 3 3 3 3 3 3 3 3 3 3 3 1 1 1 3 3 3 3 3 3 3 3 3 3 3 3 3 3 15 11 11 11 11 11 11 11 11
11 11 11 11 11 11 11 11 16 3 3 3 3 3 3 3 3 3 3 3 3 3 3 3 1 1 1 3 3 1 1 1 1 1 1 1 1 1 1 1 1 15 11 11 11 11 11 11 11 11
11 11 11 11 11 11 11 11 16 3 3 3 3 3 3 3 3 3 3 3 3 3 3 3 1 1 1 3 3 1 1 1 1 1 1 1 1 1 1 1 1 15 11 11 11 11 11 11 11 11
11 11 11 11 11 11 11 11 16 3 3 3 3 3 3 3 3 3 3 3 3 3 3 3 3 1 3 3 3 1 1 1 1 1 1 1 1 1 1 1 1 15 11 11 11 11 11 11 11 11
11 11 11 11 11 11 11 11 16 3 3 3 3 3 3 3 3 3 3 3 3 3 3 3 1 1 1 3 3 1 1 1 1 1 1 1 1 1 1 1 1 15 11 11 11 11 11 11 11 11
11 11 11 11 11 11 11 11 16 3 3 3 3 3 3 3 3 3 3 3 3 3 3 3 1 1 1 3 3 1 1 1 1 1 1 1 1 1 1 1 1 15 11 11 11 11 11 11 11 11
11 11 11 11 11 11 11 11 16 3 3 3 3 3 3 3 3 3 3 3 3 3 3 3 1 1 1 3 3 1 1 1 1 1 1 1 1 1 1 1 1 15 11 11 11 11 11 11 11 11
11 11 11 11 11 11 11 11 16 3 3 3 3 3 3 3 3 3 3 3 3 3 3 3 1 1 1 3 3 1 1 1 1 1 1 1 1 1 1 1 1 15 11 11 11 11 11 11 11 11
11 11 11 11 11 11 11 11 16 3 3 3 3 3 3 3 3 3 3 3 3 3 3 3 1 1 1 3 3 3 3 3 3 3 3 3 3 3 3 1 1 15 11 11 11 11 11 11 11 11
11 11 11 11 11 11 11 11 16 3 3 3 3 3 3 3 3 3 3 3 3 3 3 3 1 1 1 3 3 3 3 3 3 3 3 3 3 3 3 1 1 15 11 11 11 11 11 11 11 11
11 11 11 11 11 11 11 11 16 3 3 3 3 3 3 3 3 3 3 3 3 3 3 3 1 1 1 3 3 3 3 3 3 3 3 3 3 3 3 1 1 15 11 11 11 11 11 11 11 11
11 11 11 11 11 11 11 11 16 3 3 3 3 3 3 3 3 3 3 3 3 3 3 3 1 1 1 3 3 3 3 3 3 3 3 3 3 3 3 1 1 15 11 11 11 11 11 11 11 11
11 11 11 11 11 11 11 11 16 3 3 3 3 3 3 3 3 3 3 3 3 3 3 3 1 1 1 3 3 3 3 3 3 3 3 3 3 3 3 1 1 15 11 11 11 11 11 11 11 11
11 11 11 11 11 11 11 11 16 3 3 3 3 3 3 3 3 3 3 3 3 3 3 3 1 1 1 3 3 3 3 3 3 3 3 3 3 3 3 1 1 15 11 11 11 11 11 11 11 11
11 11 11 11 11 11 11 11 16 3 3 3 3 3 3 3 3 3 3 3 3 3 3 3 1 1 1 3 3 3 3 3 3 3 3 3 3 3 3 1 1 15 11 11 11 11 11 11 11 11
11 11 11 11 11 11 11 11 16 3 3 3 3 3 3 3 3 3 3 3 3 3 1 1 1 1 1 1 1 3 3 3 3 3 3 3 3 3 3 1 1 15 11 11 11 11 11 11 11 11
11 11 11 11 11 11 11 11 16 3 3 3 3 3 3 3 3 3 3 3 3 3 1 1 1 1 1 1 1 3 3 3 3 3 3 3 3 3 3 1 1 15 11 11 11 11 11 11 11 11
11 11 11 11 11 11 11 11 16 1 1 1 1 1 1 1 1 1 1 1 1 1 1 1 1 1 1 1 1 1 1 1 1 1 1 1 1 1 1 1 1 15 11 11 11 11 11 11 11 11
11 11 11 11 11 11 11 11 16 1 1 1 1 1 1 1 1 1 1 1 1 1 1 1 1 1 1 1 1 1 1 1 1 1 1 1 1 1 1 1 1 15 11 11 11 11 11 11 11 11
11 11 11 11 11 11 11 11 16 1 1 3 3 3 3 3 3 3 3 3 3 3 1 1 1 1 1 1 1 3 3 3 3 3 3 3 3 3 3 1 3 15 11 11 11 11 11 11 11 11
11 11 11 11 11 11 11 11 16 1 1 3 3 3 3 3 3 3 3 3 3 3 1 1 1 1 1 1 1 3 3 3 3 3 3 3 3 3 3 1 3 15 11 11 11 11 11 11 11 11
11 11 11 11 11 11 11 11 16 1 1 3 3 3 3 3 3 3 3 3 3 3 3 3 3 3 3 3 3 3 3 3 3 3 3 3 3 1 1 1 1 15 11 11 11 11 11 11 11 11
11 11 11 11 11 11 11 11 16 1 1 3 3 3 3 1 1 1 1 3 3 3 3 3 3 3 3 3 3 3 3 3 3 3 3 3 3 1 1 1 1 15 11 11 11 11 11 11 11 11
11 11 11 11 11 11 11 11 16 1 1 1 1 1 1 1 1 1 1 3 3 3 3 1 1 1 1 1 3 3 3 3 3 3 3 3 3 1 1 3 3 15 11 11 11 11 11 11 11 11
11 11 11 11 11 11 11 11 16 1 1 1 1 1 1 1 1 1 1 3 3 3 3 1 1 1 1 1 3 3 3 3 3 3 3 3 3 1 1 3 3 15 11 11 11 11 11 11 11 11
11 11 11 11 11 11 11 11 16 3 3 3 3 3 3 1 1 1 1 3 3 3 3 1 1 1 1 1 3 3 3 3 3 3 3 3 3 1 1 3 3 15 11 11 11 11 11 11 11 11
11 11 11 11 11 11 11 11 16 3 3 3 3 3 3 3 3 3 3 3 3 3 3 1 1 1 1 1 1 1 1 1 1 1 1 1 1 1 1 3 3 15 11 11 11 11 11 11 11 11
11 11 11 11 11 11 11 11 16 3 3 3 3 3 3 3 3 3 3 3 3 3 3 1 1 1 1 1 1 1 1 1 1 1 1 1 1 1 1 3 3 15 11 11 11 11 11 11 11 11
11 11 11 11 11 11 11 11 22 10 10 10 10 10 10 10 10 10 10 10 10 10 10 10 10 10 10 10 10 10 10 10 10 10 10 10 10 10 10 10 10 21 11 11 11 11 11 11 11 11
11 11 11 11 11 11 11 11 11 11 11 11 11 11 11 11 11 11 11 11 11 11 11 11 11 11 11 11 11 11 11 11 11 11 11 11 11 11 11 11 11 11 11 11 11 11 11 11 11 11
11 11 11 11 11 11 11 11 11 11 11 11 11 11 11 11 11 11 11 11 11 11 11 11 11 11 11 11 11 11 11 11 11 11 11 11 11 11 11 11 11 11 11 11 11 11 11 11 11 11
11 11 11 11 11 11 11 11 11 11 11 11 11 11 11 11 11 11 11 11 11 11 11 11 11 11 11 11 11 11 11 11 11 11 11 11 11 11 11 11 11 11 11 11 11 11 11 11 11 11
11 11 11 11 11 11 11 11 11 11 11 11 11 11 11 11 11 11 11 11 11 11 11 11 11 11 11 11 11 11 11 11 11 11 11 11 11 11 11 11 11 11 11 11 11 11 11 11 11 11
11 11 11 11 11 11 11 11 11 11 11 11 11 11 11 11 11 11 11 11 11 11 11 11 11 11 11 11 11 11 11 11 11 11 11 11 11 11 11 11 11 11 11 11 11 11 11 11 11 11