8 8 8 8 8 8 8 8 8 8 8 8 8 8 8 8 8 8 8 8 8 8 8 8 8 8 8 8 8 8 8 8 8 8 8 8 8 8 8 8 8 8 8 8 8 8 8 8 8 8
8 8 8 8 8 8 8 8 8 8 8 8 8 8 8 8 8 8 8 8 8 8 8 8 8 8 8 8 8 8 8 8 8 8 8 8 8 8 8 8 8 8 8 8 8 8 8 8 8 8
8 8 8 8 8 8 8 8 8 8 8 8 8 8 8 8 8 8 8 8 8 8 8 8 8 8 8 8 8 8 8 8 8 8 8 8 8 8 8 8 8 8 8 8 8 8 8 8 8 8
8 8 8 8 8 8 8 8 8 8 8 8 8 8 8 8 8 8 8 8 8 8 8 8 8 8 8 8 8 8 8 8 8 8 8 8 8 8 8 8 8 8 8 8 8 8 8 8 8 8
8 8 8 8 8 8 8 8 8 8 8 8 8 8 8 8 8 8 8 8 8 8 8 8 8 8 8 8 8 8 8 8 8 8 8 8 8 8 8 8 8 8 8 8 8 8 8 8 8 8
8 8 8 8 8 8 8 8 21 17 17 17 17 17 17 17 17 17 17 17 17 17 17 17 17 17 17 17 17 17 17 17 17 17 17 17 17 17 17 17 17 20 8 8 8 8 8 8 8 8
8 8 8 8 8 8 8 8 13 1 1 1 1 1 1 1 1 1 6 6 6 6 6 6 6 6 6 6 6 6 6 6 6 1 1 1 0 0 0 0 0 12 8 8 8 8 8 8 8 8
8 8 8 8 8 8 8 8 13 1 1 1 1 1 1 1 1 1 6 6 6 6 6 6 6 6 6 6 6 6 6 6 6 1 1 1 0 1 1 1 0 12 8 8 8 8 8 8 8 8
8 8 8 8 8 8 8 8 13 1 1 1 1 1 1 1 1 1 1 1 1 1 1 1 1 1 1 1 1 1 1 1 1 1 1 1 0 1 1 1 0 12 8 8 8 8 8 8 8 8
8 8 8 8 8 8 8 8 13 1 1 1 1 1 1 1 1 1 1 1 1 1 1 1 1 1 1 1 1 1 1 1 1 1 1 1 0 1 1 1 0 12 8 8 8 8 8 8 8 8
8 8 8 8 8 8 8 8 13 1 1 1 1 1 1 1 1 1 1 1 1 1 1 1 1 1 1 1 1 1 1 1 1 1 1 1 0 0 1 0 0 12 8 8 8 8 8 8 8 8
8 8 8 8 8 8 8 8 13 1 1 1 1 1 1 1 1 1 6 6 6 6 6 6 1 1 1 6 6 6 6 6 6 1 1 1 1 1 1 1 1 12 8 8 8 8 8 8 8 8
8 8 8 8 8 8 8 8 13 1 1 1 1 1 1 1 1 1 6 6 6 6 6 6 1 1 1 6 6 6 6 6 6 1 1 1 1 1 1 1 1 12 8 8 8 8 8 8 8 8
8 8 8 8 8 8 8 8 13 6 6 6 6 6 6 6 6 6 6 6 6 6 6 6 1 1 1 6 6 6 6 6 6 1 1 1 1 1 1 1 1 12 8 8 8 8 8 8 8 8
8 8 8 8 8 8 8 8 13 6 6 6 6 6 6 6 6 6 6 6 6 6 6 6 1 1 1 6 6 6 6 6 6 6 6 6 6 6 6 6 6 12 8 8 8 8 8 8 8 8
8 8 8 8 8 8 8 8 13 6 6 6 6 6 6 6 6 6 6 6 6 6 6 6 1 1 1 6 6 6 6 6 6 6 6 6 6 6 6 6 6 12 8 8 8 8 8 8 8 8
8 8 8 8 8 8 8 8 13 6 6 6 6 6 6 6 6 6 6 6 6 6 6 6 1 1 1 6 6 6 6 6 6 6 6 6 6 6 6 6 6 12 8 8 8 8 8 8 8 8
8 8 8 8 8 8 8 8 13 6 6 6 6 6 6 6 6 6 6 6 6 6 6 6 1 1 1 6 6 1 1 1 1 1 1 1 1 1 1 1 1 12 8 8 8 8 8 8 8 8
8 8 8 8 8 8 8 8 13 6 6 6 6 6 6 6 6 6 6 6 6 6 6 6 1 1 1 6 6 1 1 1 1 1 1 1 1 1 1 1 1 12 8 8 8 8 8 8 8 8
8 8 8 8 8 8 8 8 13 6 6 6 6 6 6 6 6 6 6 6 6 6 6 6 6 1 6 6 6 1 1 1 1 1 1 1 1 1 1 1 1 12 8 8 8 8 8 8 8 8
8 8 8 8 8 8 8 8 13 6 6 6 6 6 6 6 6 6 6 6 6 6 6 6 1 1 1 6 6 1 1 1 1 1 1 1 1 1 1 1 1 12 8 8 8 8 8 8 8 8
8 8 8 8 8 8 8 8 13 6 6 6 6 6 6 6 6 6 6 6 6 6 6 6 1 1 1 6 6 1 1 1 1 1 1 1 1 1 1 1 1 12 8 8 8 8 8 8 8 8
8 8 8 8 8 8 8 8 13 6 6 6 6 6 6 6 6 6 6 6 6 6 6 6 1 1 1 6 6 1 1 1 1 1 1 1 1 1 1 1 1 12 8 8 8 8 8 8 8 8
8 8 8 8 8 8 8 8 13 6 6 6 6 6 6 6 6 6 6 6 6 6 6 6 1 1 1 6 6 1 1 1 1 1 1 1 1 1 1 1 1 12 8 8 8 8 8 8 8 8
8 8 8 8 8 8 8 8 13 6 6 6 6 6 6 6 6 6 6 6 6 6 6 6 1 1 1 6 6 6 6 6 6 6 6 6 6 6 6 1 1 12 8 8 8 8 8 8 8 8
8 8 8 8 8 8 8 8 13 6 6 6 6 6 6 6 6 6 6 6 6 6 6 6 1 1 1 6 6 6 6 6 6 6 6 6 6 6 6 1 1 12 8 8 8 8 8 8 8 8
8 8 8 8 8 8 8 8 13 6 6 6 6 6 6 6 6 6 6 6 6 6 6 6 1 1 1 6 6 6 6 6 6 6 6 6 6 6 6 1 1 12 8 8 8 8 8 8 8 8
8 8 8 8 8 8 8 8 13 6 6 6 6 6 6 6 6 6 6 6 6 6 6 6 1 1 1 6 6 6 6 6 6 6 6 6 6 6 6 1 1 12 8 8 8 8 8 8 8 8
8 8 8 8 8 8 8 8 13 6 6 6 6 6 6 6 6 6 6 6 6 6 6 6 1 1 1 6 6 6 6 6 6 6 6 6 6 6 6 1 1 12 8 8 8 8 8 8 8 8
8 8 8 8 8 8 8 8 13 6 6 6 6 6 6 6 6 6 6 6 6 6 6 6 1 1 1 6 6 6 6 6 6 6 6 6 6 6 6 1 1 12 8 8 8 8 8 8 8 8
8 8 8 8 8 8 8 8 13 6 6 6 6 6 6 6 6 6 6 6 6 6 6 6 1 1 1 6 6 6 6 6 6 6 6 6 6 6 6 1 1 12 8 8 8 8 8 8 8 8
8 8 8 8 8 8 8 8 13 6 6 6 6 6 6 6 6 6 6 6 6 6 1 1 1 1 1 1 1 6 6 6 6 6 6 6 6 6 6 1 1 12 8 8 8 8 8 8 8 8
8 8 8 8 8 8 8 8 13 6 6 6 6 6 6 6 6 6 6 6 6 6 1 1 1 1 1 1 1 6 6 6 6 6 6 6 6 6 6 1 1 12 8 8 8 8 8 8 8 8
8 8 8 8 8 8 8 8 13 1 1 1 1 1 1 1 1 1 1 1 1 1 1 1 1 1 1 1 1 1 1 1 1 1 1 1 1 1 1 1 1 12 8 8 8 8 8 8 8 8
8 8 8 8 8 8 8 8 13 1 1 1 1 1 1 1 1 1 1 1 1 1 1 1 1 1 1 1 1 1 1 1 1 1 1 1 1 1 1 1 1 12 8 8 8 8 8 8 8 8
8 8 8 8 8 8 8 8 13 1 1 6 6 6 6 6 6 6 6 6 6 6 1 1 1 1 1 1 1 6 6 6 6 6 6 6 6 6 6 1 6 12 8 8 8 8 8 8 8 8
8 8 8 8 8 8 8 8 13 1 1 6 6 6 6 6 6 6 6 6 6 6 1 1 1 1 1 1 1 6 6 6 6 6 6 6 6 6 6 1 6 12 8 8 8 8 8 8 8 8
8 8 8 8 8 8 8 8 13 1 1 6 6 6 6 6 6 6 6 6 6 6 6 6 6 6 6 6 6 6 6 6 6 6 6 6 6 1 1 1 1 12 8 8 8 8 8 8 8 8
8 8 8 8 8 8 8 8 13 1 1 6 6 6 6 1 1 1 1 6 6 6 6 6 6 6 6 6 6 6 6 6 6 6 6 6 6 1 1 1 1 12 8 8 8 8 8 8 8 8
8 8 8 8 8 8 8 8 13 1 1 1 1 1 1 1 1 1 1 6 6 6 6 1 1 1 1 1 6 6 6 6 6 6 6 6 6 1 1 6 6 12 8 8 8 8 8 8 8 8
8 8 8 8 8 8 8 8 13 1 1 1 1 1 1 1 1 1 1 6 6 6 6 1 1 1 1 1 6 6 6 6 6 6 6 6 6 1 1 6 6 12 8 8 8 8 8 8 8 8
8 8 8 8 8 8 8 8 13 6 6 6 6 6 6 1 1 1 1 6 6 6 6 1 1 1 1 1 6 6 6 6 6 6 6 6 6 1 1 6 6 12 8 8 8 8 8 8 8 8
8 8 8 8 8 8 8 8 13 6 6 6 6 6 6 6 6 6 6 6 6 6 6 1 1 1 1 1 1 1 1 1 1 1 1 1 1 1 1 6 6 12 8 8 8 8 8 8 8 8
8 8 8 8 8 8 8 8 13 6 6 6 6 6 6 6 6 6 6 6 6 6 6 1 1 1 1 1 1 1 1 1 1 1 1 1 1 1 1 6 6 12 8 8 8 8 8 8 8 8
8 8 8 8 8 8 8 8 19 7 7 7 7 7 7 7 7 7 7 7 7 7 7 7 7 7 7 7 7 7 7 7 7 7 7 7 7 7 7 7 7 18 8 8 8 8 8 8 8 8
8 8 8 8 8 8 8 8 8 8 8 8 8 8 8 8 8 8 8 8 8 8 8 8 8 8 8 8 8 8 8 8 8 8 8 8 8 8 8 8 8 8 8 8 8 8 8 8 8 8
8 8 8 8 8 8 8 8 8 8 8 8 8 8 8 8 8 8 8 8 8 8 8 8 8 8 8 8 8 8 8 8 8 8 8 8 8 8 8 8 8 8 8 8 8 8 8 8 8 8
8 8 8 8 8 8 8 8 8 8 8 8 8 8 8 8 8 8 8 8 8 8 8 8 8 8 8 8 8 8 8 8 8 8 8 8 8 8 8 8 8 8 8 8 8 8 8 8 8 8
8 8 8 8 8 8 8 8 8 8 8 8 8 8 8 8 8 8 8 8 8 8 8 8 8 8 8 8 8 8 8 8 8 8 8 8 8 8 8 8 8 8 8 8 8 8 8 8 8 8
8 8 8 8 8 8 8 8 8 8 8 8 8 8 8 8 8 8 8 8 8 8 8 8 8 8 8 8 8 8 8 8 8 8 8 8 8 8 8 8 8 8 8 8 8 8 8 8 8 8